"filename", "language", "Java", "C++", "Typst", "Markdown", "comment", "blank", "total"
"d:\Desktop\Document\Coding\JAVA\Rep\Java-coures-report\README.md", "Markdown", 0, 0, 0, 1, 0, 2, 3
"d:\Desktop\Document\Coding\JAVA\Rep\Java-coures-report\README.typ", "Typst", 0, 0, 179, 0, 2, 39, 220
"d:\Desktop\Document\Coding\JAVA\Rep\Java-coures-report\Report\0.typ", "Typst", 0, 0, 48, 0, 4, 9, 61
"d:\Desktop\Document\Coding\JAVA\Rep\Java-coures-report\Report\1.typ", "Typst", 0, 0, 84, 0, 2, 23, 109
"d:\Desktop\Document\Coding\JAVA\Rep\Java-coures-report\Report\10.typ", "Typst", 0, 0, 550, 0, 4, 155, 709
"d:\Desktop\Document\Coding\JAVA\Rep\Java-coures-report\Report\11.typ", "Typst", 0, 0, 1068, 0, 17, 150, 1235
"d:\Desktop\Document\Coding\JAVA\Rep\Java-coures-report\Report\2.typ", "Typst", 0, 0, 116, 0, 2, 23, 141
"d:\Desktop\Document\Coding\JAVA\Rep\Java-coures-report\Report\3.typ", "Typst", 0, 0, 306, 0, 2, 49, 357
"d:\Desktop\Document\Coding\JAVA\Rep\Java-coures-report\Report\4.typ", "Typst", 0, 0, 172, 0, 5, 38, 215
"d:\Desktop\Document\Coding\JAVA\Rep\Java-coures-report\Report\5.typ", "Typst", 0, 0, 133, 0, 2, 39, 174
"d:\Desktop\Document\Coding\JAVA\Rep\Java-coures-report\Report\6.typ", "Typst", 0, 0, 736, 0, 2, 123, 861
"d:\Desktop\Document\Coding\JAVA\Rep\Java-coures-report\Report\7.typ", "Typst", 0, 0, 210, 0, 13, 45, 268
"d:\Desktop\Document\Coding\JAVA\Rep\Java-coures-report\Report\8.typ", "Typst", 0, 0, 209, 0, 5, 49, 263
"d:\Desktop\Document\Coding\JAVA\Rep\Java-coures-report\Report\9.typ", "Typst", 0, 0, 384, 0, 3, 82, 469
"d:\Desktop\Document\Coding\JAVA\Rep\Java-coures-report\Report\Java语言 实验报告模板 2023-10-8-20231214155905.typ", "Typst", 0, 0, 497, 0, 1, 263, 761
"d:\Desktop\Document\Coding\JAVA\Rep\Java-coures-report\Report\最小费用最大流问题-20231215032417.typ", "Typst", 0, 0, 323, 0, 1, 205, 529
"d:\Desktop\Document\Coding\JAVA\Rep\Java-coures-report\rubbish\myIO.java", "Java", 76, 0, 0, 0, 0, 17, 93
"d:\Desktop\Document\Coding\JAVA\Rep\Java-coures-report\sis10\Test.java", "Java", 18, 0, 0, 0, 0, 5, 23
"d:\Desktop\Document\Coding\JAVA\Rep\Java-coures-report\sis10\myLinearEntire.java", "Java", 41, 0, 0, 0, 0, 18, 59
"d:\Desktop\Document\Coding\JAVA\Rep\Java-coures-report\sis10\myLinearLib.java", "Java", 197, 0, 0, 0, 34, 13, 244
"d:\Desktop\Document\Coding\JAVA\Rep\Java-coures-report\sis10\myLinearSpace.java", "Java", 111, 0, 0, 0, 4, 18, 133
"d:\Desktop\Document\Coding\JAVA\Rep\Java-coures-report\sis10\myMatrix.java", "Java", 267, 0, 0, 0, 4, 24, 295
"d:\Desktop\Document\Coding\JAVA\Rep\Java-coures-report\sis10\myPolynomial.java", "Java", 131, 0, 0, 0, 4, 21, 156
"d:\Desktop\Document\Coding\JAVA\Rep\Java-coures-report\sis10\myRealNum.java", "Java", 58, 0, 0, 0, 3, 15, 76
"d:\Desktop\Document\Coding\JAVA\Rep\Java-coures-report\sis1\basicIO.java", "Java", 26, 0, 0, 0, 0, 3, 29
"d:\Desktop\Document\Coding\JAVA\Rep\Java-coures-report\sis2\Test.java", "Java", 54, 0, 0, 0, 0, 2, 56
"d:\Desktop\Document\Coding\JAVA\Rep\Java-coures-report\sis2\UIDmanager.java", "Java", 138, 0, 0, 0, 0, 19, 157
"d:\Desktop\Document\Coding\JAVA\Rep\Java-coures-report\sis3\Test.java", "Java", 26, 0, 0, 0, 5, 5, 36
"d:\Desktop\Document\Coding\JAVA\Rep\Java-coures-report\sis3\TrieTree.java", "Java", 37, 0, 0, 0, 0, 6, 43
"d:\Desktop\Document\Coding\JAVA\Rep\Java-coures-report\sis4\regularExp.java", "Java", 34, 0, 0, 0, 0, 4, 38
"d:\Desktop\Document\Coding\JAVA\Rep\Java-coures-report\sis5\SchoolLib.java", "Java", 186, 0, 0, 0, 31, 15, 232
"d:\Desktop\Document\Coding\JAVA\Rep\Java-coures-report\sis5\Student.java", "Java", 114, 0, 0, 0, 0, 24, 138
"d:\Desktop\Document\Coding\JAVA\Rep\Java-coures-report\sis5\Test.java", "Java", 18, 0, 0, 0, 0, 3, 21
"d:\Desktop\Document\Coding\JAVA\Rep\Java-coures-report\sis5\course.java", "Java", 76, 0, 0, 0, 0, 17, 93
"d:\Desktop\Document\Coding\JAVA\Rep\Java-coures-report\sis5\score.java", "Java", 107, 0, 0, 0, 0, 22, 129
"d:\Desktop\Document\Coding\JAVA\Rep\Java-coures-report\sis6\segTree.h", "C++", 0, 102, 0, 0, 12, 10, 124
"d:\Desktop\Document\Coding\JAVA\Rep\Java-coures-report\sis7\Test.java", "Java", 24, 0, 0, 0, 5, 5, 34
"d:\Desktop\Document\Coding\JAVA\Rep\Java-coures-report\sis7\segTree.java", "Java", 100, 0, 0, 0, 3, 14, 117
"d:\Desktop\Document\Coding\JAVA\Rep\Java-coures-report\sis8\maxFlow.java", "Java", 96, 0, 0, 0, 0, 13, 109
"d:\Desktop\Document\Coding\JAVA\Rep\Java-coures-report\sis8\minCost.java", "Java", 139, 0, 0, 0, 0, 19, 158
"d:\Desktop\Document\Coding\JAVA\Rep\Java-coures-report\sis8\solution.java", "Java", 26, 0, 0, 0, 1, 3, 30
"d:\Desktop\Document\Coding\JAVA\Rep\Java-coures-report\sis9\Bed.java", "Java", 13, 0, 0, 0, 0, 4, 17
"d:\Desktop\Document\Coding\JAVA\Rep\Java-coures-report\sis9\City.java", "Java", 21, 0, 0, 0, 0, 7, 28
"d:\Desktop\Document\Coding\JAVA\Rep\Java-coures-report\sis9\Constants.java", "Java", 10, 0, 0, 0, 0, 4, 14
"d:\Desktop\Document\Coding\JAVA\Rep\Java-coures-report\sis9\Hospital.java", "Java", 49, 0, 0, 0, 0, 19, 68
"d:\Desktop\Document\Coding\JAVA\Rep\Java-coures-report\sis9\Main.java", "Java", 32, 0, 0, 0, 0, 6, 38
"d:\Desktop\Document\Coding\JAVA\Rep\Java-coures-report\sis9\MoveTarget.java", "Java", 28, 0, 0, 0, 0, 9, 37
"d:\Desktop\Document\Coding\JAVA\Rep\Java-coures-report\sis9\MyPanel.java", "Java", 78, 0, 0, 0, 2, 15, 95
"d:\Desktop\Document\Coding\JAVA\Rep\Java-coures-report\sis9\Person.java", "Java", 145, 0, 0, 0, 0, 36, 181
"d:\Desktop\Document\Coding\JAVA\Rep\Java-coures-report\sis9\PersonPool.java", "Java", 38, 0, 0, 0, 0, 9, 47
"d:\Desktop\Document\Coding\JAVA\Rep\Java-coures-report\sis9\Point.java", "Java", 21, 0, 0, 0, 0, 7, 28
"d:\Desktop\Document\Coding\JAVA\Rep\Java-coures-report\test.java", "Java", 56, 0, 0, 0, 7, 15, 78
"Total", "-", 2591, 102, 5015, 1, 180, 1740, 9629